يبصرون	بصروا
يحدثون	حدثوا
يخرجون	خرجوا
يذكرون	ذكروا
يرزقون	رزقوا
يزعمون	زعموا
يسترون	ستروا
يسكتون	سكتوا
يشربون	شربوا
يشعرون	شعروا
يصبرون	صبروا
يصدقون	صدقوا
يطردون	طردوا
يطلبون	طلبوا
يعبدون	عبدوا
يعرفون	عرفوا
يعلمون	علموا
يغربون	غربوا
يفكرون	فكروا
يقعدون	قعدوا
يلمسون	لمسوا
يمسكون	مسكوا
ينسبون	نسبوا
ينظرون	نظروا