يبصر	بصر
يحدث	حدث
يخرج	خرج
يذكر	ذكر
يرزق	رزق
يزعم	زعم
يستر	ستر
يسكت	سكت
يشرب	شرب
يشعر	شعر
يصبر	صبر
يصدق	صدق
يطرد	طرد
يطلب	طلب
يعبد	عبد
يعرف	عرف
يعلم	علم
يغرب	غرب
يفكر	فكر
يقعد	قعد
يلمس	لمس
يمسك	مسك
ينسب	نسب
ينظر	نظر