أقدر	قدر
أقطع	قطع
أظلم	ظلم
أبد	بد
أبشر	بشر
أجد	جد
أجمل	جمل
أجنب	جنب
أحب	حب
أحسب	حسب
أحق	حق
أحل	حل
أحول	حول
أخبر	خبر
أخرج	خرج
أخلق	خلق
أذكر	ذكر
أراح	راح
أرى	رأى
أزار	زار
أسكن	سكن
أسلم	سلم
أساد	ساد
أشق	شق
أوصف	وصف
أضرب	ضرب
أوضع	وضع
أطلق	طلق
أعدى	عدا
أعرف	عرف
أعلم	علم
أعمل	عمل
أعار	عار
أغفر	غفر
أقص	قص
أقضي	قضي
أوقع	وقع
أقعد	قعد
أكثر	كثر
أمسك	مسك
أنشر	نشر
أنظر	نظر
أهدى	هدى
أهلك	هلك
أهنأ	هنأ
أهوى	هوى
آكل	أكل
آمر	أمر
آنس	أنس
أيمن	يمن
آخذ	أخذ
