تبصرون	بصرتم
تحدثون	حدثتم
تخرجون	خرجتم
تذكرون	ذكرتم
ترزقون	رزقتم
تزعمون	زعمتم
تسترون	سترتم
تسكتون	سكتتم
تشربون	شربتم
تشعرون	شعرتم
تصبرون	صبرتم
تصدقون	صدقتم
تطردون	طردتم
تطلبون	طلبتم
تعبدون	عبدتم
تعرفون	عرفتم
تعلمون	علمتم
تغربون	غربتم
تفكرون	فكرتم
تقعدون	قعدتم
تلمسون	لمستم
تمسكون	مسكتم
تنسبون	نسبتم
تنظرون	نظرتم