تبصر	بصرت
تحدث	حدثت
تخرج	خرجت
تذكر	ذكرت
ترزق	رزقت
تزعم	زعمت
تستر	سترت
تسكت	سكتت
تشرب	شربت
تشعر	شعرت
تصبر	صبرت
تصدق	صدقت
تطرد	طردت
تطلب	طلبت
تعبد	عبدت
تعرف	عرفت
تعلم	علمت
تغرب	غربت
تفكر	فكرت
تقعد	قعدت
تلمس	لمست
تمسك	مسكت
تنسب	نسبت
تنظر	نظرت