أبصر	بصرت
أحدث	حدثت
أخرج	خرجت
أذكر	ذكرت
أرزق	رزقت
أزعم	زعمت
أستر	سترت
أسكت	سكتت
أشرب	شربت
أشعر	شعرت
أصبر	صبرت
أصدق	صدقت
أطرد	طردت
أطلب	طلبت
أعبد	عبدت
أعرف	عرفت
أعلم	علمت
أغرب	غربت
أفكر	فكرت
أقعد	قعدت
ألمس	لمست
أمسك	مسكت
أنسب	نسبت
أنظر	نظرت