تبصرن	بصرتن
تحدثن	حدثتن
تخرجن	خرجتن
تذكرن	ذكرتن
ترزقن	رزقتن
تزعمن	زعمتن
تسترن	سترتن
تسكتن	سكتتن
تشربن	شربتن
تشعرن	شعرتن
تصبرن	صبرتن
تصدقن	صدقتن
تطردن	طردتن
تطلبن	طلبتن
تعبدن	عبدتن
تعرفن	عرفتن
تعلمن	علمتن
تغربن	غربتن
تفكرن	فكرتن
تقعدن	قعدتن
تلمسن	لمستن
تمسكن	مسكتن
تنسبن	نسبتن
تنظرن	نظرتن