يبصرن	بصرن
يحدثن	حدثن
يخرجن	خرجن
يذكرن	ذكرن
يرزقن	رزقن
يزعمن	زعمن
يسترن	سترن
يسكتن	سكتن
يشربن	شربن
يشعرن	شعرن
يصبرن	صبرن
يصدقن	صدقن
يطردن	طردن
يطلبن	طلبن
يعبدن	عبدن
يعرفن	عرفن
يعلمن	علمن
يغربن	غربن
يفكرن	فكرن
يقعدن	قعدن
يلمسن	لمسن
يمسكن	مسكن
ينسبن	نسبن
ينظرن	نظرن