تآكل	أكل
تآمر	أمر
تآنس	أنس
تباد	بد
تباشر	بشر
تجامل	جمل
تجانب	جنب
تحاب	حب
تحاسب	حسب
تحاق	حق
تحال	حل
تخابر	خبر
تخارج	خرج
تخالق	خلق
تذاكر	ذكر
تراءى	رأى
تراوح	راح
تساكن	سكن
تسالم	سلم
تساود	ساد
تشاق	شق
تضارب	ضرب
تظالم	ظلم
تعادى	عدا
تعالم	علم
تعالى	علا
تعامل	عمل
تعاور	عار
تقادر	قدر
تقاص	قص
تقاضي	قضى
تقاطع	قطع
تقاعد	قعد
تكاثر	كثر
تناشر	نشر
تناظر	نظر
تهادى	هدى
تهاوى	هوى
تواصف	وصف
تواضع	وضع
تواقع	وقع
تيامن	يمن
