تبصرين	بصرت
تحدثين	حدثت
تخرجين	خرجت
تذكرين	ذكرت
ترزقين	رزقت
تزعمين	زعمت
تسترين	سترت
تسكتين	سكتت
تشربين	شربت
تشعرين	شعرت
تصبرين	صبرت
تصدقين	صدقت
تطردين	طردت
تطلبين	طلبت
تعبدين	عبدت
تعرفين	عرفت
تعلمين	علمت
تغربين	غربت
تفكرين	فكرت
تقعدين	قعدت
تلمسين	لمست
تمسكين	مسكت
تنسبين	نسبت
تنظرين	نظرت