ائتخذ	أخذ
ائتكل	أكل
ائتمر	أمر
ابتد	بد
ابتشر	بشر
اجتمل	جمل
اجتنب	جنب
احتسب	حسب
احتق	حق
احتل	حل
احتال	حال
اختبر	خبر
اختلق	خلق
اذدكر	ذكر
ارتأى	رأى
ارتاح	راح
ازدار	زار
استكن	سكن
استلم	سلم
استاد	ساد
اشتق	شق
اضطرب	ضرب
اطلق	طلق
اظطلم	ظلم
اعتدى	عدا
اعترف	عرف
اعتلم	علم
اعتلي	علا
اعتمل	عمل
اعتار	عار
اغتفر	غفر
اقتدر	قدر
اقتص	قص
اقتضي	قضي
اقتطع	قطع
اقتعد	قعد
امتسك	مسك
انتشر	نشر
انتظر	نظر
اهتدى	هدى
اهتلك	هلك
اهتنأ	هنأ
اهتوى	هوى
اتصف	وصف
اتضع	وضع
اتقع	وقع
