نبصر	بصرنا
نحدث	حدثنا
نخرج	خرجنا
نذكر	ذكرنا
نرزق	رزقنا
نزعم	زعمنا
نستر	سترنا
نسكت	سكتنا
نشرب	شربنا
نشعر	شعرنا
نصبر	صبرنا
نصدق	صدقنا
نطرد	طردنا
نطلب	طلبنا
نعبد	عبدنا
نعرف	عرفنا
نعلم	علمنا
نغرب	غربنا
نفكر	فكرنا
نقعد	قعدنا
نلمس	لمسنا
نمسك	مسكنا
ننسب	نسبنا
ننظر	نظرنا