تبصران	بصرتا
تحدثان	حدثتا
تخرجان	خرجتا
تذكران	ذكرتا
ترزقان	رزقتا
تزعمان	زعمتا
تستران	سترتا
تسكتان	سكتتا
تشربان	شربتا
تشعران	شعرتا
تصبران	صبرتا
تصدقان	صدقتا
تطردان	طردتا
تطلبان	طلبتا
تعبدان	عبدتا
تعرفان	عرفتا
تعلمان	علمتا
تغربان	غربتا
تفكران	فكرتا
تقعدان	قعدتا
تلمسان	لمستا
تمسكان	مسكتا
تنسبان	نسبتا
تنظران	نظرتا