تبصران	بصرتما
تحدثان	حدثتما
تخرجان	خرجتما
تذكران	ذكرتما
ترزقان	رزقتما
تزعمان	زعمتما
تستران	سترتما
تسكتان	سكتتما
تشربان	شربتما
تشعران	شعرتما
تصبران	صبرتما
تصدقان	صدقتما
تطردان	طردتما
تطلبان	طلبتما
تعبدان	عبدتما
تعرفان	عرفتما
تعلمان	علمتما
تغربان	غربتما
تفكران	فكرتما
تقعدان	قعدتما
تلمسان	لمستما
تمسكان	مسكتما
تنسبان	نسبتما
تنظران	نظرتما