يبصران	بصرا
يحدثان	حدثا
يخرجان	خرجا
يذكران	ذكرا
يرزقان	رزقا
يزعمان	زعما
يستران	سترا
يسكتان	سكتا
يشربان	شربا
يشعران	شعرا
يصبران	صبرا
يصدقان	صدقا
يطردان	طردا
يطلبان	طلبا
يعبدان	عبدا
يعرفان	عرفا
يعلمان	علما
يغربان	غربا
يفكران	فكرا
يقعدان	قعدا
يلمسان	لمسا
يمسكان	مسكا
ينسبان	نسبا
ينظران	نظرا